border_size=1
usage=map

Rr          , Gg          , Rr          , Gg          , Xu          , Xu          , Rd          , Xu          , Xu          , Gg          , Gg          
Gg          , Rr          , Rr          , Xu          , Rd          , Rd          , Rd          , Rd          , Rd          , Xu          , Xu          
Xu          , Xu          , Rd          , Rd          , Rd          , Rd          , Rd          , Rd          , Rd          , Rd          , Xu          
Xu          , Rd          , Rd          , Rd          , Rd          , Rd          , Rd          , Rd          , Rd          , Rd          , Xu          
Xu          , Rd          , Rd          , Rd          , Rd          , Rd          , Rd          , Rd          , Rd          , Rd          , Xu          
Xu          , Rd          , Rd          , Rd          , 2 Rd        , Rd          , Rd          , 1 Rd        , Rd          , Rd          , Xu          
Xu          , Rd          , Rd          , Rd          , Rd          , Rd          , Rd          , Rd          , Rd          , Rd          , Xu          
Xu          , Rd          , Rd          , Rd          , Rd          , Rd          , Rd          , Rd          , 3 Rd        , Rd          , Xu          
Xu          , Rd          , Rd          , Rd          , Rd          , Rd          , Rd          , Rd          , Rd          , Rd          , Xu          
Uu^Uf       , Xu          , Ww          , Rd          , Rd          , Rd          , Rd          , Rd          , Rd          , Rd          , Xu          
Ww          , Ww          , Xu          , Xu          , Xu          , Rd          , Rd          , Rd          , Xu          , Xu          , Xu          
Uu^Uf       , Uu^Uf       , Xu          , Xu          , Xu          , Xu          , Xu          , Xu          , Xu          , Xu          , Xu          
