border_size=1
usage=map

Ms, Ms, Ms, Ms, Ms, Xos, Xos, Xos, Xos, Rr, Rr, Rr, Xos, Xos, Xos, Xos, Xos, Ms, Ms, Ms, Ms, Ms, Ms, Ms, Wo, Ww, Ms, Ms
Ms, Ms, Ms, Ms, Ms, Xos, Xos, Xos, Xos, Rr, Rr, Rr, Xos, Xos, Xos, Xos, Xos, Ms, Ms, Ms, Ms, Ms, Ms, Ms, Wo, Ww, Ms, Ms
Ms, Ms, Ms, 3 Kh, Ch, Xos, Xos, Xos, Xos, Rr, Rr, Rr, Xos, Xos, Xos, Xos, Cud, 4 Kud, Hh^Fdw, Ms, Hh^Fdw, Ms, Hh^Fds, Wo, Ww, Ww^Vm, Ms, Ms
Ms, Ms, Ms, Ch, Ch, Ch, Gg, Xos, Xos, Rp, Rp, Rp, Xos, Xos, Cud, Cud, Gg, Gg, Gg, Hh^Fds, Gg, Hh^Fds, Wo, Wo, Ww, Ms, Ms, Ms
Ms, Ms, Ms, Ch, Rp, Gg, Gg, Gg, Gg^Fet, Rp, Rp, Rp, Gg, Cud, Rp, Gg, Gs^Fp, Gs^Fp, Gg, Gs^Fp, Gg, Gg^Vh, Wo, Wo, Hh^Fp, Ms, Ms, Ms
Ms, Ms, Ms, Hh, Gg, Rp, Rp, Rp^Vhc, Rp^Vhc, Rp, Rp, Rp, Gg^Fet, Gg, Rp, Gg, Gs^Fp, Gs^Fmf, Gg, Gg, Wo, Wo, Gg^Wm, Gg, Re^Gvs, Hh^Fp, Ms, Ms
Ms, Ms, Ms, Hh, Gg, Gg, Gg, Gg, Gg^Fet, Rp, Rp, Rp, Rp^Vhc, Rp^Vhc, Gg, Gs^Fp, Gg, Chw, Chw, Wo, Gg, Gg, Re^Gvs, Re^Gvs, Hh^Vhh, Hh^Fp, Ms, Ms
Ms, Ms, Ms, Hh^Fp, Hh^Fp, Gg, Gg, Rp^Vhc, Rp^Vhc, Rp, Rp, Rp, Gg^Fet, Gg, Gg, Gg, Gg, Gg, Wo, Chw, Re^Gvs, Re^Gvs, Re, Re, Re^Gvs, Hh^Fp, Ms, Ms
Ms, Ms, Ms, Aa^Fda, Hh^Fp, Gg, Gg, Gg, Gg^Fet, Rp, Rp, Rp, Rp^Vhc, Rp^Vhc, Gg, Gg, Wo, Wo, Re^Gvs, Re^Gvs, Re, Re, Re^Gvs, Re^Gvs, Re^Gvs, Rp, Ha^Fma, Ms
Ms, Ms, Aa^Fda, Hh^Fp, Gg, Gg, Gg, Rp^Vhc, Rp^Vhc, Rp, Rp, Rp, Gg^Fet, Gg, Wo, Wo, Re^Gvs, Re^Gvs, Re^Gvs, Re^Gvs, Re^Gvs, Re^Gvs, Re^Gvs, Re^Gvs, Re^Gvs, Rp, Ms, Ms
Ms, Aa^Fda, Aa^Fda, Hh^Fp, Gg, Gg, Gg, Gg, Gg^Fet, Rp, Ur, Ur, Wo, Wo, Wo, Wwf, Re^Gvs, Re^Gvs, Re^Gvs, Re^Gvs, Re^Gvs, Re^Gvs, Re^Gvs, Re^Gvs, Gg^Wm, Rp, Ms, Ms
Wo, Aa^Fda, Hh^Fp, Hh^Fp, Gg, Gg, Gg, Gg, Re, Ur, Ww^Bw|, Ww^Bw|, Ss, Wo, Re^Gvs, Re^Gvs, Re^Gvs, Re^Gvs, Re^Gvs, Re^Gvs, Re^Gvs, Re^Gvs, Gg^Vh, Gg, Rp, Rp, Ms, Ms
Ms, Wo, Wo, Wo, Wo, Gg, Ss, Re, Wo, Ww^Bw|, Ur, Ur, Re^Gvs, Re^Gvs, Re^Gvs, Re^Gvs, Re^Gvs, Re^Gvs, Re^Gvs, Re^Gvs, Re^Gvs, Re^Gvs, Rp, Rp, Gs^Fms, Gs^Fp, Ms, Ms
Ms, Ms, Re, Re, Ss^Vm, Wo, Wo, Wo, Re, Ur, Rp, Rp, Re^Gvs, Re^Gvs, Re^Gvs, Re^Gvs, Re^Gvs, Re^Gvs, Re^Gvs, Re^Gvs, Rp, Rp, Gs^Ft, Gs^Ft, Gs^Ft, Gs^Fp, Ms, Ms
Ms, Ms, Re, Re, Re, Ss, Ww, Re, Re, Rp, Rp, Rp, Re^Gvs, Re^Gvs, Re^Gvs, Re^Gvs, Xos, Re^Gvs, Rp, Rp, Gs^Ft, Gs^Ft, Gs^Ft, Gs^Ft, Gs^Fms, Gs^Fp, Ms, Ms
Ms, Ms, Ww, Re, Ww, Ww, Re, Re, Re, Rp, Rp, Rp, Re^Gvs, Re^Gvs, Re^Gvs, Xos, Xos, Xos, Xos, Xos, Xos, Ur, Ur, Gs^Ft, Gs^Ft, Gs^Fp, Gs^Fp, Ms
Ms, Ms, Ms, Ww, Ww, Re, Re, Re, Re^Gvs, Rp, Rp, Rp, Re^Gvs, Re^Gvs, Xos, Xos, Xos, Xos, Uh, Uu, Qlf, Uh, Uu, Ur, Gs^Fms, Gs^Fp, Ms, Ms
Ms, Ms, Ms, Ww, Re^Gvs, Re^Gvs, Re^Gvs, Re^Gvs, Re^Gvs, Rp, Rp, Rp, Rp, Rp, Xos, Xos, Uu, Uu, Qlf, Qlf, Ql, Ql, Uh, Ur, Gs^Ft, Gs^Fp, Ms, Ms
Ms, Ms, Ms, Ww, Ww, Re^Gvs, Re^Gvs, Re^Gvs, Re^Gvs, Rp, Rp, Rp, Gg^Fet, Gg, Gg, Xos, Ur, Qlf, Ql, Ql, Ql, Ql, Uh, Gs^Ft, Gs^Ft, Gs^Fp, Ms, Ms
Ms, Ms, Ms, Gs^Fdf, Ww, Re^Gvs, Ww, Re^Gvs, Re^Gvs, Rp, Rp, Rp, Gg, Gs^Ft, Gs^Ft, Gg, Ur, Uu, Ql, Ql, Uh, Uh, Uu^Vud, Gs^Fms, Gs^Fms, Gs^Fp, Ms, Ms
Ms, Ms, Ms, Gs^Fmf, Re^Gvs, Re^Gvs, Re^Gvs, Re^Gvs, Re^Gvs, Rp, Rp, Rp, Gg^Fet, Gg, Gs^Ft, Gs^Ft, Gs^Ft, Uu, Uu, Ql, Ql, Uu, Uu, Ur, Ur, Gs^Fp, Ms, Ms
Ms, Ms, Hh^Vhh, Gs^Fmf, Re^Gvs, Re^Gvs, Re^Gvs, Re^Gvs, Re^Gvs, Rp, Rp, Rp, Gg, Gg, Gs^Ft, Gs^Fms, Gs^Ft, Gs^Fms, Gs^Fms, Uu, Uu, Ql, Ql^Bs/, Uu, Uu, Uu, Ms, Ms
Ms, Ms, Ms, Gs^Fmf, Gs^Fmf, Re, Re^Gvs, Re^Gvs, Re^Gvs, Rp, Rp, Rp, Gg, Gs^Fms, Gs^Fms, Gs^Fms, Gs^Fms, Gs^Fms, Gs^Ft, Gs^Fms, Ur, Uu, Uu, Ql, Ql, Ur, Ms, Ms
Ms, Ms, Ms, Gs^Fmf, Re^Gvs, Re^Gvs, Re^Gvs, Re^Gvs, Re^Gvs, Rp, Rp, Rp, Gs^Fms, Gs^Fms, Gg, Gg, Gg, Gs^Ft, Gs^Ft, Ss, Ss, Uu, Uu^Vud, Uu, Ql, Ur, Ms, Ql
Ms, Ms, Ms, Gs^Fmf, Re^Gvs, Re^Gvs, Re^Gvs, Re, Re^Gvs, Rp, Rp, Rp, Gg, Gg, Gg, Gg^Vh, Gg, Gs^Ft, Gs^Ft, Ss, Ss, Ur, Uu, Uu, Ql, Ql, Ql, Ql
Ms, Ms, Ms, Gs^Fmf, Re^Gvs, Re^Gvs, Re^Gvs, Re^Gvs, Re^Gvs, Rp, Rp, Rp, Gg, Gg, Gg, Gg, Gg, Gs^Ft, Gs^Ft, Ss, Ww, Ur, Uu, Uu, Ql, Ql, Ms, Ql
Ms, Ms, Ms, Gs^Fdf, Hh^Fdf, Re^Gvs, Re^Gvs, Re^Gvs, Re^Gvs, Rp, Rp, Rp, Gg, Gg, Gg, Gg, Gg^Vh, Gg, Gg, Gs^Ft, Ss, Ur, Uu, Ql, Uu, Ur, Ms, Ms
Ms, Ms, Ms, Hh^Fdf, Aa^Fma, Hh^Fdf, Re, Re, Re, Rp, Rp, Rp, Gg, Gg, Gg, Gg, Gg, Gg, Gs^Ft, Gs^Ft, Gg, Ur, Uu, Ql, Uu, Ur, Ms, Ms
Ms, Ms, Aa^Fma, Aa^Fma, Hh^Fdf, Hh^Fdf, Re, Re, Gg^Vh, Rp, Rp, Rp, Gg, Gg^Vh, Gg, Gg, Gg, Gg, Gs^Ft, Gs^Fms, Gg, Gs^Fms, Uu, Ql, Uu, Ur, Ms, Ms
Ms, Ms, Aa^Fma, Hh^Fdf, Gs^Fmf, Re^Gvs, Re^Gvs, Re, Re^Gvs, Rp, Rp, Rp, Gg, Gg, Gg, Gg, Gg, Gg, Gg, Gs^Ft, Gg, Gg, Uu, Ql, Uu, Ur, Ms, Ms
Ms, Ms, Aa^Fma, Gs^Fdf, Gs^Fmf, Re^Gvs, Re, Re^Gvs, Re^Gvs, Rp, Rp, Rp, Gg, Gg, Gg, Gg, Gg, Gs^Ft, Gs^Ft, Gg, Gs^Ft, Gg, Uu, Ql, Uu, Ur, Ms, Ms
Ms, Ms, Ms, Gs^Fmf, Gs^Fmf, Re^Gvs, Re^Gvs, Re^Gvs, Re^Gvs, Rp, Rp, Rp, Gg, Gg, Gg, Gg, Gg^Vh, Gg, Gs^Ft, Gs^Ft, Gg, Gg, Uu, Ql, Uu, Ur, Ms, Ms
Ms, Ms, Ms, Aa^Fma, Gs^Fmf, Gs^Fmf, Re^Gvs, Re^Gvs, Re^Gvs, Rp, Rp, Rp, Gg, Gg, Gg, Gg, Gg, Gg, Gs^Ft, Gs^Ft, Gg, Gg, Uu, Ql, Uu, Ur, Ms, Ms
Ms, Ms, Ms, Aa^Fma, Gs^Fmf, Re, Re, Re^Gvs, Re^Gvs, Rp, Rp, Rp, Gg, Gg, Gg, Gg, Gg, Gg, Gs^Ft, Gs^Ft, Gg, Gg, Uu, Ql, Uu, Uu, Ms, Ms
Ms, Ms, Aa^Fda, Aa^Fma, Gs^Fmf, Gg, Gg, Gg^Wm, Gg, Rp, Rp, Rp, Gg, Gg, Gg, Gg, Gg, Gg, Gg, Gg, Gs^Ft, Gg, Uu, Ql, Ql, Uu, Ms, Ms
Ms, Ms, Aa^Fda, Gs^Fmf, Re, Re, Re, Gg, Gg, Rp, Rp, Rp, Gg, Gg, Gg, Gg^Vh, Gg, Ww, Gg, Gs^Ft, Gs^Ft, Gg, Ur, Uu, Ql, Uu, Ms, Ms
Ms, Ms, Aa^Fda, Gs^Fmf, Re, Re, Re, Gg, Re, Rp, Rp, Rp, Gg, Gg, Gg, Gg, Gg, Gs^Ft, Gs^Ft, Gg, Dd^Vda, Dd, Ur, Uu, Ql, Uu, Ms, Ms
Ms, Ms, Aa^Fda, Gs^Fmf, Gs^Fmf, Re, Re, Re, Re, Rp, Rp, Rp, Gg, Gg, Gg, Gg, Gg, Gs^Ft, Gs^Ft, Gs^Ft, Gs^Ft, Dd, Ur, Uu, Ql, Uu, Ms, Ms
Ms, Ms, Ms, Aa^Fda, Ce, Ce, Ce, Re, Re, Rp, Rp, Rp, Gg, Gg, Gg, Gg, Gg, Gg^Vh, Gs^Ft, Dd, Gs^Ft, Gs^Ft, Ur, Ur, Ql, Uu, Ms, Ms
Xu, Ms, Ms, Aa^Fda, Ce, 1 Ke, Ce, Re, Re, Rp, Rp, Rp, Cud, Gg, Gg, Gg, Gg, Gg, Dd, Dd, Gs^Ft, Dd, Ur, Uu, Ql, Uu, Ms, Ms
Xu, Xu, Ai, Ww, Ww, Ce, Xu, Re, Xu, Rp, Rp, Rp, 2 Kud, Cud, Cud, Gg, Hd, Dd, Dd, Gs^Ft, Dd, Dd, Ur, Uu, Ql, Ql, Xu, Xu
Xu, Xu, Xu, Xu, Xu, Xu, Xu, Xu, Xu, Rr, Rr, Rr, Xu, Xu, Xu, Xu, Xu, Hd, Xu, Hd, Xu, Hd, Ur, Uu, Ur, Ql, 5 Uh, Xu
Xu, Xu, Xu, Xu, Xu, Xu, Xu, Xu, Xu, Rr, Rr, Rr, Xu, Xu, Xu, Xu, Xu, Xu, Xu, Xu, Xu, Xu, Xu, Ur, Uh, Ql, Ql, Uh
Xu, Xu, Xu, Xu, Xu, Xu, Xu, Xu, Xu, Rr, Rr, Rr, Xu, Xu, Xu, Xu, Xu, Xu, Xu, Xu, Xu, Xu, Xu, Xu, Xu, Uh, Uh, Ql
