border_size=1
usage=map

Xu, Xu, Xu, Xu, Xu, Xu, Wwf, Xu, Xu, Xu, Xu, Xu, Xu, Xu, Xu, Xu, Xu, Xu, Ur, Xu, Xu, Xu, Xu, Xu, Xu, Xu, Xu, Xu, Xu, Xu
Xu, Xu, Xu, Xu, Xu, Xu, Wwf, Xu, Xu, Xu, Xu, Xu, Xu, Xu, Xu, Xu, Xu, Xu, Ur, Xu, Xu, Xu, Xu, Xu, Xu, Xu, Xu, Xu, Xu, Xu
Xu, Xu, Xu, Xu, Xu, Xu, Gs^Fp, Gs^Ii, Gs^Ii, Xu, Xu, Xu, Xu, Xu, Ur, Ur, Ur, Xu, Ur, Xu, Ur, Ur, Xu, Xu, Xu, Xu, Xu, Xu, Xu, Xu
Xu, Xu, Xu, Xu, Gs^Fp, Gs^Fp, Re^Gvs, Gs, Gs, Gs^Ii, Re, Xu, Ur, Ur, Xu, Xu, Xu, Ur, Ur, Ur, Xu, Ur, Xu, Xu, Dd, Dd^Dr, Dd, Xu, Xu, Xu
Xu, Xu, Xu, Xu, Xu, Gs, Gs, Gs, Xu, Xu, Ur^Ii, Ur^Ii, Xu, Xu, Ur, Xu, Xu, Xu, Ur, Xu, Xu, Ur, Xu, Xu, Xu, Dd, Xu, Xu, Ur, Ur
Xu, Xu, Xu, Xu, Xu, Xu, Xu, Xu, Ur, Ur, Xu, Rd, Xu, Xu, Ur, Xu, Xu, Xu, Ur, Xu, Xu, Ur, Xu, Xu, Xu, Ur, Ur, Ur, Xu, Xu
Xu, Xu, Xu, Xu, Uu^Uf, Xu, Ur, Ur, Xu, Xu, Gs, Re^Ii, Xu, Xu, Ur, Xu, Xu, Xu, Ur, Xu, Xu, Ur, Xu, Xu, Ur, Ur, Xu, Xu, Xu, Xu
Xu, Xu, Xu, Uu^Uf, Ur, Ur, Xu, Xu, Re, Re, Re^Gvs, Gg, Xu, Xu, Ur, Xu, Xu, Xu, Ur, Xu, Xu, Ur, Ur, Ur, Xu, Xu, Xu, Xu, Xu, Xu
Ur, Xu, Ur, Ur, Xu, Xu, Re, Re, Re^Gvs, Re^Gvs, Gg, Gg, Xu, Xu, Ur, Xu, Xu, Xu, Cud, Xu, Xu, Xu, Xu, Xu, Xu, Xu, Xu, Xu, Xu, Xu
Xu, Ur, Xu, Xu, Xu, Gs, Re^Gvs, Re^Gvs, Re, Re, Xu, Xu, Ur, Ur, Ur, Ur, Xu, Xu, Kud, Xu, Xu, Xu, Xu, Xu, Wo, Xu, Xu, Xu, Xu, Xu
Xu, Xu, Xu, Xu, Xu, Xu, Xu, Re, Xu, Xu, Ur, Ur, Ur, Ur, Xu, Xu, Xu, Xu, Cud, Cud, Ur^Dr, Xu, Wo, Wo, Xu, Xu, Xu, Xu, Xu, Xu
Xu, Xu, Xu, Xu, Xu, Xu, Xu, Xu, Ur, Ur, Ur, Ur, Xu, Xu, Qxu, Rr, Rr, Ur, Xu, Xu, Xu, Xu, Xu, Xu, Xu, Xu, Xu, Xu, Xu, Xu
Ms^Xm, Xu, Xu, Xu, Ms^Xm, Ms^Xm, Xu, 2 Hd, Ur, Ur, Xu, Xu, Qxu, Qxu, Rr, Qxu^Bs/, Qxu, Xu, Xu, Xu, Dd, Xu, Dd, Xu, Dd, Xu, Xu, Xu, Xu, Xu
Md, Ms^Xm, Ms^Xm, Ms^Xm, Md, Ms^Xm, Mm^Xm, Xu, Xu, Xu, Qxu, Qxu, Rr, Rr, Qxu, Qxu, Xu, Xu, Dd, Dd, Hd, Dd, Dd, Dd, Dd, Dd, Dd, Xu, Dd, Xu
Md, Md, Md, Md, Md, Md, Md, Md^Xm, Mm^Xm, Xu, Rr, Rr, Qxu, Qxu, Xu, Xu, Dd, Dd, Dd, Ds, Ds, Dd^Do, Hd, Dd, Dd, Dd, Dd, Dd, Dd, Hd
Dd, Dd, Dd, Md, Dd, Md, Md, Md, Rd, Rr, Ds, Qxu, Xu, Xu, Dd^Dc, Dd, Dd, Dd, Dd, Dd, Dd, Ds, Dd, Hd, Hd, Dd, Dd, Dd, Xu, Xu
Dd, Dd, Dd, Dd, Dd, Dd, Rd, Rd, Dd, Rr, Rr, Ds, Ds, Ds, Ds, Ds, Ds, Dd, Dd, Hd, Dd, Dd, Dd, Dd^Dc, Rr, Hd, Hd, Xu, Xu, Xu
Dd, Dd, Dd, Dd, Rd, Rd, Dd, Dd, Dd, Dd, Dd, Rr, Rr, Rr, Rr, Rr, Rr, Rr, Rr, Rr, Rr, Rr, Rr, Rr, Dd, Rr^Dr, 1 Rr, Xu, Ur, Xu
Dd^Dc, Dd, Rd, Rd, Dd, Dd, Dd, Dd, Dd, Dd, Dd, Dd, Dd, Ds, Dd, Dd, Dd, Dd, Dd, Dd, Dd, Dd, Dd, Dd, Dd, Dd, Xu, Rr, Rr, Xu
Rd, Rd, Dd, Dd, Dd, Dd, Dd, Hd, Hd, Dd, Dd, Dd, Dd, Ds, Ds, Dd, Dd, Dd, Dd, Dd, Dd, Dd, Dd, Dd, Xu, Xu, Xu, Xu, Xu, Rr
