border_size=1
usage=map

Xu          , Xu          , Xu          , Xu          , Xu          , Xu          , Mm          , Mm          , Mm          , Hh^Fp       , Hh          , Mm          , Mm^Xm       , Mm^Xm       , Mm^Xm       , Gg          , Gs^Fp       , Gs^Fp       , Gg          , Gs^Fp       , Gg          , Gg          , Gg          , Gg          , Ss          , Ss          , Ss          , Gs^Fmf      , Gs^Fmf      , Hh          , Hh          , Ww          , Wo          , Wo          , Wo          , Wo          , Wo          , Wo          
Xu          , Xu          , Xu          , Xu          , Ur          , Ds          , Ds          , Hh^Fp       , Hh^Fp       , Hh^Fp       , Hh          , Hh          , Hh          , Mm^Xm       , Hh^Fmw      , Gs^Fp       , Gs^Fp       , Gs^Fp       , Gs^Fp       , Gs^Fp       , Gg          , Gg          , Gg^Vh       , Gg          , Gg          , Gg          , Gs^Fmf      , Gs^Fmf      , Gs^Fmf      , Gs^Fmf      , Gg          , Ww          , Ww          , Ww          , Ww          , Ww          , Ww          , Wo          
Re          , Xu          , Xu          , Ur          , Xu          , Xu          , Hh          , Ds          , Ds          , Gs^Fmf      , Gs^Fmf      , Hh^Fmw      , Hh          , Mm^Xm       , Hh^Fmw      , Gs^Fp       , Gs^Fp       , Gs^Fp       , Gs^Fdw      , Gs^Fp       , Gg^Ve       , Gs^Fp       , Gg          , Gg          , Gg          , Gg          , Gg          , Gs^Fmf      , Gs^Fmf      , Gs^Fmf      , Gs^Fmf      , Gg^Vh       , Hh^Fp       , Hh^Fp       , Hh^Fp       , Gg^Vh       , Ww          , Ww          
Rr          , Xu          , Xu          , Ur          , Xu          , Xu          , Hh^Fdf      , Hh^Fdf      , Hh^Fdf      , Ds          , Ds          , Hh^Fmw      , Hh^Fmw      , Mm^Xm       , Hh^Fmw      , Gs^Fp       , Gs^Fp       , Gs^Fp       , Gs^Fp       , Gs^Fp       , Gs^Fp       , Gs^Fp       , Gg          , Gg          , Gg          , Gg          , Gg          , Gg          , Gg          , Gg          , Gs^Fmf      , Gs^Fmf      , Hh^Fp       , Hh^Fp       , Hh^Fp       , Hh^Fp       , Hh^Fp       , Ss          
Xu          , Rr          , Rr          , Ur          , Dd^Dc       , Xu          , Xu          , Hh^Fdf      , Hh^Fdf      , Gs^Fmf      , Ds          , Hh^Fmw      , Hh^Fmw      , Mm^Xm       , Hh^Fmw      , Gs^Fdw      , Gs^Fp       , Gs^Fp       , Gs^Fp       , Hh^Fp       , Gs^Fp       , Gs^Fp       , Gs^Fp       , Gs^Fp       , Gg          , Gg          , Gg          , Gg          , Gg          , Gs^Fmf      , Gs^Fmf      , Gs^Fmf      , Gs^Fmf      , Gs^Fmf      , Hh^Fp       , Hh^Fp       , Hh^Fp       , Ss          
Xos         , Xos         , Uu^Vu       , Rr          , Uu^Uf       , Uu^Vu       , Xu          , Hh^Fdf      , Hh^Fdw      , Hh^Fdw      , Ds          , Hh^Fmw      , Gs^Fdw      , Mm^Xm       , Mm^Xm       , Hh^Fmw      , Gs^Fp       , Hh^Fp       , Hh^Fp       , Hh^Fp       , Hh^Fp       , Gs^Fp       , Gs^Fp       , Gs^Fp       , Gg          , Gg          , Gg          , Gg          , Gg          , Gs^Fmf      , Gg          , Ch          , Ch          , Ch          , Hh^Fp       , Hh^Fp       , Hh^Fp       , Ss          
Xos         , Uu^Uf       , Uu^Uf       , Cud         , Cud         , Cud         , Xu          , Hh^Fdw      , Hd          , Hd          , Ds          , Hh^Fdw      , Hh^Fdw      , Hh^Fmw      , Mm^Xm       , Hh^Fmf      , Gs^Fp       , Gs^Fp       , Ds          , Ds          , Ds          , Hh^Fp       , Gs^Fp       , Gg          , Gg          , Gg          , Gg          , Gg          , Ds          , Gs^Fmf      , Ch          , Ch          , 3 Kh        , Ch          , Hh^Fp       , Hh^Fp       , Hh^Fp       , Hh^Fp       
Xos         , Wwr         , Uu^Uf       , Cud         , 2 Kud       , Cud         , Xu          , Hd          , Ds          , Ds          , Dd          , Gs^Fdw      , Gs^Fdw      , Gs^Fdw      , Mm^Xm       , Hh^Fms      , Ds          , Ds          , Gs^Fp       , Gg          , Gg          , Gs^Fp       , Gs^Fp       , Gg          , Gs^Fp       , Ds          , Gs^Fp       , Ds          , Gg          , Ds          , Ch          , Ch          , Ch          , Hh^Fp       , Hh^Fp       , Gg^Vh       , Hh^Fp       , Hh^Fp       
Xos         , Wwr         , Cud         , Cud         , Cud         , Cud         , Xu          , Hd          , Ds          , Dd          , Dd          , Gs^Fdw      , Mm^Xm       , Mm^Xm       , Hh^Fmf      , Hh^Fms      , Hh^Fp       , Hh^Fp       , Hh^Fp       , Gs^Fp       , Gg          , Ds          , Gs^Fp       , Ds          , Gs          , Gs^Fmf      , Gs          , Gg          , Gg          , Gs          , Gs          , Gg          , Ds          , Hh^Fp       , Hh^Fp       , Hh^Fp       , Hh^Fp       , Hh^Fp       
Xos         , Wwr         , Wwr         , Uu          , Rr          , Xu          , Xu          , Hd          , Ds          , Dd          , Dd          , Gs^Fdw      , Mm^Xm       , Hh^Fms      , Hh^Fp       , Hh^Fp       , Hh^Fp       , Hh^Fp       , Hh^Fp       , Gs^Fp       , Gs^Fp       , Gs^Fp       , Gs^Fdw      , Gs^Vht      , Gg          , Gs          , Gg          , Gs          , Gg          , Gs          , Gs^Vht      , Gs          , Gs          , Ds          , Ds          , Hh^Fp       , Hh^Fp       , Gs^Fp       
Qxu         , Xos         , Qxu         , Qxu         , Qxu^Bs|     , Qxu         , Xu          , Hd          , Ds          , Dd          , Dd          , Dd          , Mm^Xm       , Hh^Fms      , Hh^Fp       , Hh^Fp       , Hh^Fp       , Hh^Fp       , Hh^Fp       , Gs^Fp       , Gs^Fp       , Gs^Fmf      , Gs^Fmf      , Gs^Fdw      , Gs^Fdw      , Gg          , Gs          , Gg          , Gs          , Gs          , Gs          , Gs          , Gg          , Gs          , Gs          , Ds          , Hh^Fp       , Hh^Fp       
Xu          , Qxu         , Xu          , Qxu         , Rp          , Qxu         , Xu          , Hd          , Hh^Fmw      , Gs^Fp       , Mm^Xm       , Mm^Xm       , Hh^Fmf      , Hh^Fmf      , Hh^Fp       , Hh^Fp       , Hh^Fp       , Hh^Fp       , Gs^Fp       , Gs^Fp       , Gs^Fp       , Gs^Fp       , Gs^Fp       , Gs^Fp       , Gs^Fp       , Gg          , Gs          , Gs          , Gs          , Hh          , Gs          , Gs          , Gs          , Gg          , Ds          , Ds          , Hh^Fp       , Hh          
Mm          , Xu          , Re          , Re          , Rp          , Uh          , Mm^Xm       , Mm^Xm       , Hh^Fmw      , Mm^Xm       , Hh^Fms      , Hh^Fms      , Hh^Fp       , Hh^Fp       , Hh^Fp       , Gs^Fp       , Gs^Fp       , Gs^Fp       , Gg^Ve       , Gs^Fp       , Gg          , Gg          , Gg          , Gg          , Gg          , Gs^Fp       , Gg          , Gg          , Hh          , Hh          , Hh          , Hh          , Hh          , Hh          , Ds          , Hh          , Ss          , Hh          
Mm          , Mm          , Re          , Re          , Rp          , Mm          , Mm^Xm       , Gs^Fp       , Gs^Fp       , Gs^Fp       , Gs^Fp       , Gs^Fp       , Gs^Fp       , Gs^Fp       , Gs^Fp       , Gs^Fp       , Gg          , Gs^Fp       , Gs^Fp       , Gs^Fp       , Gg          , Gg          , Gg          , Gg          , Gg          , Gs^Fp       , Gg          , Hh          , Hh          , Hh          , Hh          , Mm          , Mm          , Mm          , Ss          , Ss          , Ww          , Ss          
Re          , Re          , Gs          , Re          , Rp          , Mm^Xm       , Gs^Fp       , Gg^Ve       , Gs^Fp       , Ss          , Ss          , Gs^Fp       , Gs^Fp       , Ss          , Gg          , Gg          , Gg          , Gs^Fp       , Gg          , Gs^Fp       , Gs^Fp       , Gg          , Gg          , Gg          , Gg          , Gs^Fp       , Gg^Ve       , Hh          , Hh          , Hh          , Mm          , Mm          , Mm          , Mm          , Chs         , Ww          , Ww^Vm       , Ww          
Gs          , Gs          , Gs          , Re          , Rp          , Mm^Xm       , Hh^Fmw      , Gs^Fp       , Ss          , Ss          , Ww          , Ss          , Ss          , Gg          , Gg^Vh       , Gg          , Gg          , Gs^Fp       , Gg          , Gg          , Gs^Fp       , Gg          , Gg          , Gg          , Gg          , Gg          , Gs^Fp       , Gs^Fp       , Hh          , Hh          , Mm          , Mm          , Mm          , Mm          , Khs         , Ww          , Ww          , Ww          
Gs          , Gs          , Gs          , Gs          , Rp          , Mm^Xm       , Mm^Xm       , Gs^Fp       , Ss          , Ww          , Wo          , Ww          , Ss          , Gg          , Gg          , Gg          , Gg          , Gs^Fp       , Gg          , Gg          , Gg          , Gs^Fp       , Gs^Fp       , Gg          , Gg          , Gg          , Gs^Fp       , Gs^Fp       , Hh          , Hh          , Mm          , Mm          , Hh^Fds      , Hh^Dr       , Chs         , Ww          , Ww          , Ww          
Re          , Gs          , Re          , Gs          , Rp          , Re          , Mm^Xm       , Gs^Fp       , Ss          , Ww          , Ww          , Ww          , Ss          , Gg          , Gg          , Gg          , Gg          , Gs^Fp       , Gg          , Gg          , Gg          , Gg          , Gs^Fp       , Gs^Fp       , 5 Gs^Fp     , Gs^Fp       , Gs^Fp       , Gs^Fp       , Gg          , Hh          , Hh^Fds      , Mm          , Hh^Fds      , Chs         , Ww          , Ww          , Ww          , Ww          
Hh^Fp       , Re          , Gs          , Gs          , Gs          , Rp          , Gs^Fp       , Mm^Xm       , Mm^Xm       , Hh^Fmw      , Hh^Fmw      , Dd          , Ds          , Gg          , Gg          , Gg          , Gg          , Gs^Fp       , Gg          , Gg          , Gs^Fmf      , Gg          , Gg          , Gg          , Gs^Fp       , Gs^Fp       , Gs^Fp       , Gg          , Gg          , Gg          , Hh          , Hh^Fds      , Hh^Fds      , Ss          , Ss          , Ww          , Ds          , Ww          
Hh^Fp       , Re          , Gs          , Gs          , Gs          , Rp          , Rp          , Gg          , Mm^Xm       , Mm^Xm       , Hh^Fmw      , Ds          , Gg          , Gg          , Gg          , Gg          , Gg          , Gg^Ve       , Gs^Fp       , Gg          , Gg          , Gg          , Gg          , Gg          , Gs^Fp       , Gg          , Gg          , Gg          , Gg          , Gg          , Gg          , Hh          , Mm          , Hh^Fds      , Hh^Fds      , Hd          , Ds          , Ww          
Re          , Re          , Gs          , Gs          , Gs^Fp       , Gs^Fp       , Gs^Fp       , Rp          , Rp          , Hh^Fmw      , Gg          , Gg          , Gs^Fp       , Gs^Fp       , Gs^Fp       , Gs^Fp       , Gs^Fp       , Gs^Fp       , Gs^Fp       , Gg          , Gg          , Gg          , Gg^Vh       , Gg          , Gg          , Gg          , Gg          , Gg          , Gg          , Gg          , Gg          , Gg          , Hh          , Mm          , Mm          , Hh^Fds      , Re          , Ds          
Hh          , Re          , Gs          , Gs          , Gs^Fp       , Gg^Ve       , Gs^Fp       , Gs^Fp       , Gs^Fp       , Rp          , Rp          , Gs^Fp       , Gg          , Gg          , Gs^Fp       , Gg^Ve       , Gs^Fp       , Gs^Fp       , Kv          , Cv          , Gg          , Gg          , Gg          , Gg          , Gg          , Gg          , Gg          , Gg          , Gg^Vh       , Gg          , Gg          , Gg          , Gg          , Gg          , Hh          , Hh          , Re          , Mm          
Hh          , Hh          , Hh          , Gs          , Gs          , Gs^Fp       , Gs^Fp       , Gs^Fp       , Gg          , Gg          , Rp          , Gg          , Gg          , Gg          , Gg          , Gs^Fp       , Gs^Fp       , Gs^Fp       , Cv          , Gg          , Gs^Fmf      , Gs^Fmf      , Gg          , Gg          , Gg          , Gg          , Gg          , Gg          , Gg          , Gg          , Gg          , Gg          , Gg          , Gg          , Re          , Re          , Hh          , Ww          
Mm          , Mm          , Hh          , Hh          , Hh          , Hh          , Gg^Ve       , Gs^Fp       , Gs^Fp       , Gg          , Rp          , Gg          , Gg          , Gg          , Gg          , Gg          , Gg          , Gg          , Gg          , Gg          , Gs^Fmf      , Gs^Fmf      , Gs^Fmf      , Gg          , Gg          , Gs^Fp       , Gs^Fp       , Gg          , Gg          , Gg          , Gg          , Gg          , Gg          , Gg          , Re          , Gg          , Gg          , Ww          
Mm          , Mm          , Mm          , Mm          , Mm          , Hh          , Hh          , Gs^Fp       , Gg          , Gs^Fp       , Rp          , Gg          , Gg          , Gg          , Gg          , Gg          , Gg          , Gg^Vh       , Gg          , Gs^Fmf      , Gs^Fmf      , Gs^Fmf      , Gs^Fmf      , Gg          , Gg          , Gs^Fp       , Gs^Fp       , Gs^Fp       , Gs^Fp       , Gg          , Gg          , Gg          , Gs^Fp       , Gs^Fp       , Re          , Gg          , Gs^Fp       , Ww          
Mm          , Mm          , Mm          , Mm          , Mm          , Mm          , Hh          , Hh          , Gg          , Gs^Fp       , Rp          , Gg          , Gg          , Gg          , Gg          , Gs^Fmf      , Gs^Fmf      , Gg          , Gg          , Gg          , Gg          , Gs^Fmf      , Gs^Fmf      , Gg          , Gg          , Gs^Fp       , Gg^Ve       , Gs^Fp       , Gs^Fp       , Gg          , Gg          , Gs^Fp       , Gs^Fp       , Gs^Fp       , Re          , Gg          , Ww          , Ww          
Mm          , Mm          , Mm          , Mm          , Mm          , Mm          , Mm          , Hh          , Hh          , Hh          , Rp          , Rp          , Re          , Gg          , Gg          , Gg          , Gg          , Gg          , Gg          , Gg          , Gs^Fmf      , Gs^Fmf      , Gs^Fmf      , Gg          , Gg          , Gs^Fp       , Gs^Fp       , Gs^Fp       , Gg^Ve       , Gs^Fp       , Gs^Fp       , Gs^Fp       , Gs^Fp       , Gs^Fp       , Re          , Gg          , Ww          , Ww          
Mm          , Mm          , Mm          , Mm          , Mm          , Mm          , Mm          , Mm          , Rp          , Rp          , Gg          , Gg^Vh       , Gg          , Re          , Re          , Gg          , Gg          , Gg          , Gg          , Gg          , Gg          , Gg          , Gg          , Gg          , Gg          , Gg          , Gs^Fp       , Gs^Fp       , Gs^Fp       , Gs^Fp       , Gs^Fp       , Gs^Fp       , Re          , Re          , Gg          , Gg          , Gg^Vh       , Ww^Bw/      
Mm          , Mm          , Mm          , Mm          , Rp          , Mm          , Rp          , Rp          , Mm          , Hh          , Hh          , Gg          , Gg          , Gg          , Re          , Gg          , Gg          , Gg          , Gg          , Gg          , Gs^Fp       , Gg          , Gg          , Gg          , Gs^Fmf      , Gg          , Gg          , Gg          , Gs^Fp       , Gs^Fp       , Gg          , Re          , Gg          , Gg          , Gg          , Gg          , Gg          , Ww          
Mm          , Mm          , Rp          , Rp          , Mm          , Rp          , Mm          , Mm          , Mm^Xm       , Mm          , Hh          , Gg          , Gg          , Gg          , Gg          , Re          , Re          , Gs^Fp       , Gs^Fp       , Gs^Fp       , Gs^Fp       , Gs^Fp       , Gg          , Gg          , Gs^Fmf      , Gg          , Gg          , Gg          , Gg          , Ds          , Re          , Re          , Gg          , Gg          , Gg          , Gg          , Gs^Fp       , Ww          
Rp          , Rp          , Mm          , Mm          , Mm          , Mm          , Mm          , Mm          , Mm^Xm       , Mm          , Gg          , Gg          , Gg          , Gs^Fmf      , Gs^Fmf      , Gg          , Re          , Gs^Fp       , Gs^Fp       , Gg^Ve       , Gs^Fp       , Gs^Fp       , Gg          , Gg          , Gg          , Gg          , Re^Gvs      , Gg          , Re          , Re          , Re^Gvs      , Re^Gvs      , Gg          , Gg          , Gg          , Gs^Fp       , Gs^Fp       , Gg          
Mm          , Mm          , Mm          , Mm          , Mm          , Mm          , Mm          , Mm          , Mm          , Hh          , Gg          , Gg          , Gg          , Gs^Fmf      , Gs^Fmf      , Re          , Gg          , Re          , Re          , Gs^Fp       , Re          , Gs^Fp       , Gs^Fp       , Gg          , Gg^Vh       , Re^Gvs      , Re          , Re          , Gg          , Gg^Vh       , Gg          , Gg          , Gg          , Gg          , Gg          , Gs^Fp       , Gg^Ve       , Hh          
Mm          , Mm          , Mm          , Mm          , Mm          , Mm          , Mm^Xm       , Mm          , Mm          , Hh          , Gg^Vh       , Gg          , Gg          , Gs^Fmf      , Gs^Fmf      , Re          , Gg          , Gg          , Gg          , Re          , Gs^Fp       , Re          , Re          , Re          , Re          , Re          , Gg          , Gg          , Gg^Wm       , Gg          , Gg          , Gg          , Gg          , Gg          , Gs^Fp       , Gs^Fp       , Gs^Fp       , Hh          
Mm          , Mm          , Mm          , Mm          , Mm          , Mm          , Mm          , Mm          , Mm          , Hh          , Gg          , Gg          , Gg          , Gg          , Re          , Re          , Gg          , Gg          , Gg          , Gg          , Gs^Fp       , Gs^Fp       , Gs^Fp       , Gs^Fp       , Re          , Gg          , Gg          , Gg          , Gg          , Gg          , Gg          , Gg          , Gg          , Gg          , Gs^Fp       , Hh          , Hh          , Ww          
Mm          , Mm          , Mm          , Mm          , Mm          , Mm          , Mm          , Mm          , Mm          , Hh          , Gg          , Gg          , Re          , Re          , Gg          , Gs^Fp       , Gg          , Gg          , Gg          , Gs^Fp       , Gs^Fp       , Gs^Fp       , Gg          , Gg          , Re          , Gg          , Gg          , Gg          , Gg          , Gg          , Gg          , Gg          , Gg          , Gg          , Hh          , Hh          , Ww          , Ww          
Mm          , Mm          , Mm          , Mm          , Mm          , Mm          , Mm          , Mm          , Hh          , Hh^Fp       , Gs^Fmf      , Gs^Fmf      , Re          , Gg^Vh       , Gs^Fp       , Gs^Fp       , Gs^Fp       , Gs^Fp       , Gs^Fp       , Gg          , Gs^Fp       , Gs^Fp       , Gg          , Gs^Fp       , Re          , Gg          , Gg          , Gg          , Gg          , Gg          , Gg          , Gg          , Gg          , Ww          , Ww          , Ww          , Ww          , Ww          
Mm          , Mm          , Mm          , Mm^Xm       , Mm          , Mm          , Mm          , Hh          , Hh          , Gs^Fmf      , Gs^Fmf      , Gs^Fmf      , Re          , Gg          , Gs^Fp       , Gs^Fp       , Gg^Ve       , Gs^Fp       , Gs^Fp       , Gg          , Gg          , Gg          , Re^Gvs      , Re^Gvs      , Re^Gvs      , Re          , Re          , Gg          , Gg          , Gg          , Gg          , Gg          , Hh          , Ww          , Ww          , Ww          , Ds          , Ds          
Mm          , Mm          , Mm^Xm       , Mm          , Mm          , Mm^Xm       , Hh          , Hh          , Hh          , Gs^Fmf      , Gs^Fmf      , Gs^Fmf      , Gg          , Gg          , Gs^Fp       , Gs^Fp       , Gs^Fp       , Gs^Fp       , Gs^Fp       , Gg          , Gg          , Gg          , Gg          , Re^Gvs      , Gg          , Gg^Vh       , Re          , Gg          , Gs^Fp       , Gg          , Hh          , Hh          , Hh          , Mm          , Ww          , Ww          , Ww          , Ww          
Mm          , Mm          , Mm^Xm       , Mm          , Hh          , Hh          , Hh          , Hh          , Re          , Gs^Fmf      , Gs^Fmf      , Gs^Fmf      , Gg          , Gs^Fp       , Gs^Fp       , Gg          , Gs^Fp       , Gs^Fp       , Gg          , Gg          , Gs^Fp       , Gg          , Gg          , Gg          , Gg          , Gg          , Re          , Gg          , Hh^Fp       , Hh^Vhh      , Mm          , Mm          , Mm          , Mm          , Mm          , Ww          , Ww^Vm       , Ww          
Ss          , Mm          , Mm          , Mm          , Hh          , Hh          , Re          , Re          , Re^Gvs      , Re^Gvs      , Gg          , Gg          , Gg          , Gs^Fp       , Gg          , Gg          , Ss          , Gs^Fp       , Gg          , Gg          , Gs^Fp       , Gs^Fp       , Gg          , Gg          , Gg          , Gg          , Re          , Gg          , Hh^Fp       , Hh^Fp       , Mm          , Mm          , Mm          , Mm          , Mm          , Ww          , Ww          , Ww          
Ww          , Ww          , Hh          , Ch          , Ch          , Ch          , Hh          , Gg^Vh       , Gg          , Gg          , Gg          , Gg          , Gg          , Gs^Fp       , Gg^Ve       , Gs^Fp       , Gs^Fp       , Gs^Fp       , Gs^Fp       , Gs^Fp       , Gs^Fp       , Gs^Fp       , Gs^Fp       , Gs^Fp       , Gg          , Re          , Gg          , Gg          , Hh^Fp       , Mm          , Mm          , Mm          , Mm          , Mm          , Ww          , Ww          , Ww          , Ww          
Ww          , Ww          , Ch          , Ch          , 4 Kh        , Ch          , Hh          , Hh          , Hh          , Hh          , Gg          , Gg          , Gs^Fp       , Gs^Fp       , Gs^Fp       , Gs^Fp       , Ss          , Gs^Fp       , Gs^Fp       , Gg^Ve       , Gs^Fp       , Gs^Fp       , Gs^Fp       , Gs^Fp       , Gs^Fp       , Re          , Gg          , Gg          , Hh^Fp       , Mm          , Mm          , Mm          , Mm          , Ww          , Ww          , Ww          , Ww          , Ww          
Ww          , Gg^Vh       , Ch          , Ch          , Ch          , Hh          , Hh          , Hh          , Mm          , Mm          , Hh          , Hh          , Gs^Fp       , Gg^Ve       , Gs^Fp       , Gg          , Gg          , Ss          , Gs^Fp       , Gs^Fp       , Gs^Fp       , Gg          , Gg          , Gg          , Gs^Fp       , Re          , Gg          , Gg          , Hh^Fp       , Mm          , Mm          , Mm          , Mm          , Mm          , Mm          , Ww          , Ww          , Ww          
Gg          , Gg          , Re          , Re          , Hh          , Mm          , Mm          , Mm^Vhh      , Mm          , Mm          , Mm          , Hh          , Hh          , Gs^Fp       , Gg          , Gg          , Gg          , Gs^Fp       , Gs^Fp       , Gs^Fp       , Gs^Fp       , Gs^Fp       , Gg          , Gg          , Gs^Fp       , Re          , Gg          , Hh^Fp       , Hh^Vhh      , Mm          , Mm          , Mm          , Mm          , Mm          , Mm          , Ww          , Ww          , Ww          
Gg          , Gg          , Re          , Hh          , Hh          , Mm          , Mm          , Mm          , Mm          , Mm          , Mm          , Mm          , Hh          , Gg          , Gg          , Gg          , Gg          , Gs^Fp       , Gs^Fp       , Gg          , Gg          , Gs^Fp       , Gg          , Gg          , Gs^Fp       , Re          , Re          , Hh^Fp       , Hh^Fp       , Mm          , Mm          , Mm          , Mm          , Mm          , Mm          , Mm          , Ww          , Ww          
Hh^Fdf      , Hh^Fdf      , Re          , Hh^Fdf      , Mm          , Mm          , Mm          , Mm          , Mm          , Mm          , Mm          , Mm          , Mm          , Hh          , Gg          , Gs^Fp       , Gs^Fp       , Gs^Fp       , Gg          , Gg          , Gg          , Gs^Fp       , Gs^Fp       , Gg          , Re^Vct      , Gs^Fp       , Re          , Hh^Fp       , Hh^Fp       , Mm          , Mm          , Mm          , Mm          , Mm          , Mm          , Mm          , Re^Vct      , Ww          
Hh^Fdf      , Hh^Fdf      , Re          , Hh^Fdf      , Mm          , Mm          , Mm          , Mm          , Mm          , Mm          , Mm          , Mm          , Mm          , Hh          , Hh          , Gs^Fp       , Gs^Fp       , Gg          , Gg          , Gg          , Gg          , Gs^Fp       , Gs^Fp       , Gs^Fp       , Gs^Fp       , Gs^Fp       , Re          , Gg          , Hh^Fp       , Mm          , Mm          , Mm          , Re          , Re          , Re          , Re          , Re          , Ww          
Gg          , Re          , Hh^Fdf      , Hh          , Hh          , Mm          , Mm          , Mm          , Mm          , Mm          , Mm          , Mm          , Mm          , Hh          , Hh          , Gs^Fp       , Gs^Fp       , Gs^Fp       , Gg          , Gg          , Gs^Fp       , Gs^Fp       , Gs^Fp       , Gs^Fp       , Gs^Fp       , Gs^Fp       , Re          , Ce          , Ce          , Ce          , Mm          , Re          , Hh^Fdf      , Hh^Fdf      , Hh^Fdf      , Hh^Fdf      , Hh^Fdf      , Re          
Gg          , Re          , Gg          , Gg          , Hh          , Mm          , Mm          , Mm          , Mm          , Mm          , Mm          , Mm          , Mm          , Hh          , Gs^Fp       , Gg          , Gg          , Gs^Fp       , Gs^Fp       , Gs^Fp       , Gg^Ve       , Gs^Fp       , Gs^Fp       , Gs^Fp       , Gs^Fp       , Gs^Fp       , Ce          , Ce          , 1 Ke        , Ce          , Re          , Re          , Hh^Fdf      , Hh^Fdf      , Hh^Fmf      , Hh^Fdf      , Hh^Fdf      , Hh^Fdf      
Gg          , Re          , Re          , Gg          , Hh          , Hh          , Hh          , Mm          , Mm          , Mm          , Mm          , Mm          , Mm          , Hh          , Gg^Vh       , Re^Gvs      , Re^Gvs      , Gg          , Gs^Fp       , Gs^Fp       , Gs^Fp       , Gs^Fp       , Gs^Fp       , Gs^Fp       , Re          , Gs^Fp       , Ce          , Ce          , Ce          , Re          , Hh^Fp       , Hh^Fdf      , Hh^Fdf      , Hh^Fdf      , Hh^Fmf      , Hh^Fdf      , Hh^Fdf      , Hh^Fdf      
Gs^Fp       , Gs^Fp       , Re          , Gg          , Gg          , Hh          , Hh          , Hh          , Hh          , Mm          , Mm          , Mm          , Mm          , Hh          , Hh          , Re^Gvs      , Re^Gvs      , Gg          , Gg          , Gg          , Gg          , Gs^Fp       , Gs^Fp       , Hh^Fp       , Hh^Fp       , Hh^Fp       , Hh^Fp       , Hh^Fp       , Hh^Fp       , Re          , Hh^Fdf      , Hh^Fdf      , Hh^Fdf      , Hh^Fdf      , Hh^Fdf      , Hh^Fdf      , Hh^Fdf      , Hh^Fdf      
Gg          , Gs^Fp       , Gs^Fp       , Re          , Re          , Gg          , Hh          , Hh          , Hh          , Hh          , Mm          , Mm          , Mm          , Hh          , Hh          , Re^Gvs      , Re^Gvs      , Re^Gvs      , Gg^Vh       , Gg          , Gg          , Gg          , Hh^Fp       , Hh^Fp       , Hh^Fp       , Hh^Fdf      , Hh^Fdf      , Hh^Fdf      , Hh^Fdf      , Re^Vct      , Hh^Fdf      , Hh^Fdf      , Hh^Fdf      , Hh^Fdf      , Hh^Fdf      , Hh^Fmf      , Hh^Fdf      , Hh^Fdf      
Gg          , Gs^Fp       , Gg^Ve       , Gs^Fp       , Gs^Fp       , Re          , Re^Gvs      , Re^Gvs      , Gg^Vh       , Hh          , Hh          , Hh          , Hh          , Hh          , Hh          , Re          , Gs^Fmf      , Re^Gvs      , Re^Gvs      , Gg          , Gg          , Gg          , Hh^Fp       , Hh^Fdf      , Hh^Fdf      , Hh^Fdf      , Hh^Fdf      , Hh^Fdf      , Hh^Fdf      , Hh^Fdf      , Hh^Fdf      , Hh^Fdf      , Hh^Fmf      , Hh^Fdf      , Hh^Fdf      , Hh^Fdf      , Hh^Fdf      , Hh^Fdf      
Gs^Fp       , Gs^Fp       , Gs^Fp       , Gs^Fp       , Gs^Fp       , Re          , Re          , Re^Gvs      , Re          , Hh          , Hh          , Hh          , Hh          , Hh          , Gg          , Gg          , Gg          , Re          , Re          , Re          , Re          , Re          , Hh^Fdf      , Hh^Fdf      , Hh^Fdf      , Hh^Fdf      , Hh^Fdf      , Hh^Fdf      , Hh^Fdf      , Hh^Fdf      , Hh^Fdf      , Hh^Fdf      , Hh^Fdf      , Hh^Fdf      , Hh^Fdf      , Hh          , Hh          , Hh          
