border_size=1
usage=map

Xu, Xu, Xu, Xu, Xu, Xu, Xu, Xu, Xu, Xu, Xu, Xu, Aa^Ii, Xu, Xu, Xu, Xu, Xu, Xu, Xu, Xu, Xu, Xu, Xu, Xu, Xu, Xu, Xu, Xu, Xu, Xu, Xu, Xu, Xu, Xu, Xu, Xu, Xu, Xu, Xu, Xos, Xos, Xos, Xos, Xos, Xos, Xos, Xos, Xos, Xos, Xos, Xos
Xu, Xu, Xu, Xu, Xu, Xu, Xu, Xu, Uu, Xu, Xu, Xu, Xu, Aa^Ii, Aa^Ii, Xu, Xu, Xu, Ai, Xu, Xu, Xu, Xu, Xu, Xu, Xu, Xu, Xu, Xu, Xu, Xu, Xu, Xu, Xu, Wwf, Rr, Rr, Xu, Xu, Xu, Ql, Xos, Xos, Xos, Xos, Xos, Re^Ii, Xos, Xos, Xos, Xos, Xos
Xu, Xu, Xu, Xu, 1 Kud, Cud, Cud, Uu, Xu, Uu, Uu, Xu, Xu, Xu, Xu, Aa, Aa, Aa, Aa, Ai, Ai, Xu, Xu, Xu, Xu, Xu, Cud, Kud, Cud, Cud, Rr, Xu, Wwf, Wwf, Rr, Wwf, Wwf, Rr, Xu, Xu, Ql, Ql, Ql, Xos, Xos, Re^Ii, Re^Ii, Re^Ii, Xos, Xos, Rr, Rr
Xu, Xu, Xu, Cud, Cud, Cud, Xu, Xu, Xu, Xu, Xu, Uu, Uh, Xu, Aa, Aa, Ai, Ai, Ai, Ai, Wwf, Uh, Uu, Xu, Uu, Cud, Xu, Xu, Xu, Xu, Wwf, Wwf, Rr, Rr, Xu, Xu, Xu, Wwf, Wwf, Xu, Ql, Ql, Ql, Ql, Ql, Xos, Xos, Xos, Rr, Rr, Xos, Xos
Xu, Xu, Xu, Xu, Rr, Xu, Rd, Xu, Uu^Uf, Xu, Xu, Xu, Xu, Uu, Uu, Ai, Uh, Uh, Uu, Uu, Wwf, Xu, Wwf, Uh, Xu, Xu, Wwf, Xu, Wwf, Wwf, Xu, Xu, Xu, Xu, Xu, Xu, Wwf, Wwf, Xu, Xu, Ql, Ql, Ql, Ql, Ql, Ql, Ql^Bs/, Rr, Xos, Xos, Re^Ii, Xos
Xu, Xu, Xu, Rr, Rd, Rd, Uu^Uf, Rd, Wwr, Uu^Uf, Xu, Xu, Xu, Xu, Xu, Uu, Uu, Uu, Xu, Uu, Uu, Wwf, Xu, Wwf, Wwf, Wwf, Xu, Wwf, Xu, Xu, Xu, Xu, Xu, Xu, Xu, Xu, Wwf, Rr, Xu, Xu, Xu, Ql, Ql, Ql, Ql^Bs/, Ql^Bs/, Ql, Ql, Ql, Xos, Xos, Xos
Xu, Xu, Xu, Rd, Xu, Xu, Xu, Uu^Vud, Xu, Xu, Xu, Xu, Xu, Xu, Xu, Xu, Xu, Uu, Uu, Uu, Xu, Xu, Xu, Xu, Xu, Xu, Xu, Xu, Xu, Xu, Xu, Xu, Xu, Xu, Xu, Xu, Wwf, Rr, Rr, Xu, Rr, Ql, Ql^Bs/, Ql^Bs/, Ql, Ql, Ql, Ql, Ql, Ql, Ql, Xos
Xu, Xu, Xu, Xu, Xu, Xu, Xu, Xu, Xu, Xu, Xu, Xu, Xu, Xu, Xu, Xu, Xu, Xu, Xu, Xu, Xu, Xu, Xu, Xu, Xu, Xu, Xu, Xu, Xu, Xu, Xu, Xu, Xu, Xu, Xu, Xu, Xu, Wwf, Wwf, Rr, Rr, Ql^Bs/, Ql, Ql, Ql, Ql, Ql, Ql, Ql, Ql, Ql, Ql
Xu, Xu, Xu, Xu, Xu, Xu, Xu, Xu, Xu, Xu, Xu, Xu, Xu, Xu, Xu, Xu, Xu, Xu, Xu, Xu, Xu, Xu, Xu, Xu, Xu, Xu, Xu, Xu, Xu, Xu, Xu, Xu, Xu, Xu, Xu, Xu, Xu, Wwf, Wwf, Wwf, Rr, Rr, Xu, Ql, Xu, Ql, Ql, Ql, Ql, Ql, Ql, Ql
Xu, Xu, Xu, Xu, Ur, Xu, Xu, Xu, Xu, Xu, Xu, Xu, Xu, Xu, Xu, Xu, Xu, Xu, Xu, Xu, Xu, Xu, Xu, Xu, Xu, Xu, Xu, Xu, Xu, Xu, Xu, Xu, Xu, Xu, Ur, Ur, Ur, Wwf, Xu, Xu, Xu, Xu, Xu, Xu, Xu, Xu, Xu, Ql, Xu, Ql, Xu, Xu
Xu, Xu, Xu, Ur, Cud, Ur, Ur, Xu, Xu, Xu, Xu, Xu, Xu, Xu, Xu, Xu, Xu, Xu, Xu, Xu, Xu, Xu, Xu, Xu, Xu, Xu, Xu, Xu, Xu, Xu, Xu, Xu, Ur, Ur, Ur, Ur, Uu^Uf, Wwf, Wwf, Xu, Xu, Xu, Xu, Xu, Xu, Xu, Xu, Xu, Xu, Xu, Xu, Xu
Xu, Xu, Xu, Ur, Xu, Xu, Ur, Ur, Ur, Xu, Xu, Xu, Xu, Xu, Xu, Xu, Xu, Xu, Xu, Xu, Xu, Xu, Xu, Xu, Xu, Xu, Xu, Xu, Uu^Uf, Uu^Vu, Uu, Xu, Re, Ur, Ur, Xu, Xu, Uu^Uf, Uu^Uf, Wwf, Wwf, Xu, Xu, Xu, Xu, Xu, Xu, Xu, Xu, Xu, Wo, Xu
Xu, Xu, Xu, Ur, Xu, Xu, Xu, Ur, Ur, Ur, Ur, Xu, Xu, Xu, Xu, Xu, Xu, Xu, Xu, Xu, Xu, Xu, Xu, Xu, Xu, Xu, Uu, Uu, Uu, Uu, Re, Uu, Uu, Xu, Xu, Xu, Xu, Xu, Xu, Uu^Uf, Uu^Uf, Wwf, Wwf, Wwf, Wwf, Xu, Xu, Xu, Wo, Wo, Wo, Wo
Xu, Xu, Xu, Ur, Xu, Xu, Xu, Xu, Xu, Ur, Ur, Ur, Ur, Xu, Cud, Xu, Rr, Rr, Rr, Xu, Hd, Xu, Xu, Xu, Xu, Uu^Vu, Uu, Uu^Uf, Re, Uu, Uu, Uu, Uu, Uu^Vu, Xu, Xu, Xu, Xu, Xu, Xu, Xu, Uu^Uf, Uu^Uf, Wwf, Wwf, Wwf, Wwf, Ww, Ww, Wo, Xu, Wo
Xu, Xu, Xu, Ur, Xu, Xu, Xu, Xu, Xu, Xu, Xu, Ur, Ur, Ur, Ur, Rr, Cud, Rr, Cud, Ds, Ds, Hd, Hd, Xu, Xu, Xu, Re, Uu, Uu, Uu, Uu^Uf, Uu, Uu, Xu, Uh, Xu, Uu^Uf, Uu^Uf, Uu^Uf, Xu, Xu, Xu, Uu^Uf, Xu, Wwf, Ww, Ww, Wwf, Wwf, Ww, Xu, Xu
Xu, Xu, Xu, Ur, Uu^Uf, Xu, Xu, Xu, Xu, Xu, Xu, Xu, Xu, Xu, Xu, Xu, Cud, Rr, Cud, Xu, Xu, Ur, Ds, Ur, Qxu^Bs/, Ur, Ur, Re, Xu, Uu^Vu, Xu, Xu, Xu, Wwg, Xu, Xu, Uu^Uf, Uu^Uf, Uu^Uf, Uu^Uf, Xu, Xu, Wwf, Wwf, Wwf, Wwf, Xu, Xu, Xu, Wwf, Wwf, Xu
Xu, Xu, Xu, Ur, Ur, Uu^Uf, Uu^Uf, Xu, Xu, Xu, Xu, Xu, Xu, Xu, Xu, Xu, Rr, Rr, Rr, Xu, Xu, Xu, Hd, Ur, Qxu, Ur, Xu, Xu, Xu, Xu, Xu, Xu, Xu, Wwg, Xu, Wwf, Wwf, Uu^Uf, Uu^Uf, Uu^Vu, Xu, Xu, Wwf, Wwf, Xu, Xu, Xu, Xu, Xu, Xu, Xu, Wwf
Xu, Xu, Xu, Uu, Uu, Ur, Ur, Xu, Uu, Xu, Xu, Xu, Xu, Xu, Xu, Rr, Cud, Rr, Cud, Rr, Xu, Xu, Xu, Hd, Qxu, Xu, Xu, Xu, Xu, Xu, Ds, Uu^Uf, Uu^Uf, Xu, Uu^Uf, Uu^Uf, Uu^Uf, Wwf, Uu^Uf, Uu^Uf, Uu^Uf, Uu^Uf, Wwf, Uu^Uf, Uu^Vu, Xu, Xu, Xu, Xu, Xu, Xu, Xu
Xu, Xu, Xu, Xu, Xu, Uu, Xu, Ur, Ur, Uu, Xu, Xu, Xu, Xu, Xu, Cud, Xu, Cud, Xu, Cud, Xu, Xu, Xu, Hd, Qxu, Xu, Xu, Xu, Xu, Hd, Hd, Ds, Ds, Uu^Uf, Uu^Vu, Uu^Uf, Uu^Uf, Wwf, Wwf, Wwf, Wwf, Wwf, Uu^Uf, Uu^Uf, Cud, Cud, Cud, Xu, Xu, Xu, Xu, Xu
Xu, Xu, Xu, Xu, Xu, Xu, Uu, Uu, Xu, Ur, Ur, Uu, Xu, Xu, Xu, Xu, Xu, Kud, Xu, Xu, Xu, Xu, Xu, Ds^Dr, Qxu, Uh, Xu, Xu, Xu, Hd, Uu^Uf, Uu^Uf, Uu^Uf, Uu^Uf, Uu^Uf, Uu^Uf, Uu^Uf, Wwf, Uu^Uf, Uu^Uf, Uu^Uf, Uu^Uf, Uu^Uf, Uu^Uf, Cud, Kud, Cud, Xu, Xu, Xu, Xu, Xu
Xu, Xu, Xu, Xu, Xu, Xu, Xu, Xu, Xu, Uu, Uu, Ur, Ur, Xu, Xu, Xu, Xu, Xu, Xu, Xu, Xu, Xu, Xu, Uh, Qxu, Xu, Xu, Xu, Xu, Ds, Ds, Uu^Uf, Uu^Uf, Uu^Uf, Uu^Uf, Uu^Uf, Uu^Uf, Uu^Uf, Uu^Uf, Uu^Uf, Uu^Uf, Uu^Uf, Uu^Uf, Uu^Uf, Xu, Cud, Xu, Xu, Xu, Xu, Xu, Xu
Xu, Xu, Xu, Xu, Xu, Xu, Xu, Xu, Xu, Xu, Xu, Uu, Xu, Ur, Ur, Uu, Xu, Xu, Xu, Xu, Xu, Xu, Xu, Uh, Qxu, Xu, Xu, Xu, Xu, Xu, Xu, Uu^Vu, Xu, Uu^Uf, Uu^Uf, Uu^Uf, Xu, Uu^Uf, Uu^Uf, Uu^Uf, Uu^Uf, Uu^Uf, Xu, Xu, Xu, Xu, Xu, Xu, Xu, Xu, Xu, Xu
